20 20
mossy_cobble
striped_oak_log
oak_planks
level_2

XXXXXXXXXXXXXXXXXXXX
X                  X
X T                X
X               X  X
X   X   X   X   X  X
X               X  X
X               X  X
X               X  X
X   X   X   X   X  X
X               X  X
X               X  X
X               X  X
X   X   X   X   X  X
X               X  X
X               X  X
X               X  X
X  XXXXXXXXXXXXXX  X
X                  X
X                 SX
XXXXXXXXXXXXXXXXXXXX