8 8
AAAAAAAA
AEEEAENA
AEEAAEEA
AEEAEEEA
AEEEEEEA
AEEEEEAA
AAAEEAAA
AAAEEAAA